id,time,dominance,pos,pos1,pos2,neg,neg1,neg2,f_p1,f_p2,hp1,hp2
0,12:23:46,1,1,1,0,0,0,0,-1,1,321,345
1,12:23:47,1,1,1,0,0,0,0,-1,1,321,345
2,12:23:48,1,2,2,0,0,0,0,-1,1,321,345
3,12:23:49,0.5,3,3,0,1,1,0,-0.5,0.5,311,325
4,12:23:50,0.714285714285714,6,6,0,1,1,0,-0.714285714285714,0.714285714285714,311,325
5,12:23:51,0.714285714285714,12,12,0,2,2,0,-0.714285714285714,0.714285714285714,311,325
6,12:23:52,0.5,16,15,1,4,4,0,-0.5,0.5,311,320
7,12:23:53,0.6,19,18,1,6,4,2,-0.6,0.6,311,320
8,12:23:54,0.625,26,24,2,6,4,2,-0.625,0.625,311,320
9,12:23:55,0.631578947368421,30,28,2,8,5,3,-0.631578947368421,0.631578947368421,299,289
10,12:23:56,0.619047619047619,33,31,2,9,6,3,-0.619047619047619,0.619047619047619,299,289
11,12:23:57,0.48936170212766,34,32,2,13,10,3,-0.48936170212766,0.48936170212766,299,289
12,12:24:04,0.478260869565217,36,34,2,33,16,17,-0.478260869565217,0.478260869565217,277,182
13,12:24:04,0.486486486486487,39,35,4,35,15,20,-0.486486486486487,0.486486486486487,277,182
14,12:24:05,0.462365591397849,45,38,7,48,18,30,-0.462365591397849,0.462365591397849,277,182
15,12:24:06,0.428571428571429,37,30,7,47,17,30,-0.428571428571429,0.428571428571429,277,182
16,12:24:07,0.475,35,29,6,45,15,30,-0.475,0.475,257,172
17,12:24:08,0.44,32,26,6,43,15,28,-0.44,0.44,257,172
18,12:24:09,0.402985074626866,24,19,5,43,15,28,-0.402985074626866,0.402985074626866,257,172
19,12:24:13,0.469387755102041,17,12,5,32,8,24,-0.469387755102041,0.469387755102041,257,150
20,12:24:14,0.469387755102041,17,12,5,32,8,24,-0.469387755102041,0.469387755102041,257,150
21,12:24:15,0.483870967741935,15,10,5,16,3,13,-0.483870967741935,0.483870967741935,257,150
22,12:24:16,0.485714285714286,19,13,6,16,3,13,-0.485714285714286,0.485714285714286,127,120
23,12:24:17,0.458333333333333,28,20,8,20,5,15,-0.458333333333333,0.458333333333333,127,120
24,12:24:18,0.43859649122807,34,25,9,23,7,16,-0.43859649122807,0.43859649122807,127,120
25,12:24:19,0.39622641509434,28,20,8,25,8,17,-0.39622641509434,0.39622641509434,127,70
26,12:24:20,0.291666666666667,29,22,7,19,10,9,-0.291666666666667,0.291666666666667,127,70
27,12:24:21,0.180327868852459,37,25,12,24,13,11,-0.180327868852459,0.180327868852459,127,70
28,12:24:22,0.159420289855072,41,29,12,28,17,11,-0.159420289855072,0.159420289855072,107,70
29,12:24:23,0.0864197530864197,45,33,12,36,25,11,-0.0864197530864197,0.0864197530864197,107,70
30,12:24:30,0.1,52,34,18,48,27,21,-0.1,0.1,87,55
31,12:24:30,0.1,52,34,18,48,27,21,-0.1,0.1,87,55
32,12:24:31,0.0736842105263158,47,30,17,48,27,21,-0.0736842105263158,0.0736842105263158,75,15
33,12:24:32,0.037037037037037,38,23,15,43,24,19,-0.037037037037037,0.037037037037037,75,15
34,12:24:33,0.0277777777777778,31,19,12,41,23,18,-0.0277777777777778,0.0277777777777778,75,15
35,12:24:35,-0.0333333333333333,26,15,11,34,20,14,0.0333333333333333,-0.0333333333333333,75,15
36,12:24:36,-0.0588235294117647,23,12,11,28,16,12,0.0588235294117647,-0.0588235294117647,75,15
37,12:24:37,-0.0526315789473684,14,8,6,24,14,10,0.0526315789473684,-0.0526315789473684,75,15
38,12:24:38,0,0,0,0,0,0,0,0,0,400,400
39,12:24:39,0,0,0,0,0,0,0,0,0,400,400
40,12:24:40,0,0,0,0,0,0,0,0,0,400,400
41,12:24:41,0,0,0,0,0,0,0,0,0,390,380
42,12:24:42,0,0,0,0,0,0,0,0,0,390,380
43,12:24:43,0,0,0,0,0,0,0,0,0,380,380
44,12:24:44,0,0,0,0,0,0,0,0,0,380,370
45,12:24:45,0,0,0,0,0,0,0,0,0,380,370
46,12:24:46,0,0,0,0,0,0,0,0,0,358,370
47,12:24:47,0,1,1,0,1,1,0,0,0,358,365
48,12:24:48,0.4,7,7,0,3,3,0,-0.4,0.4,358,365
49,12:24:50,0.333333333333333,10,10,0,5,5,0,-0.333333333333333,0.333333333333333,346,335
50,12:24:51,0.170731707317073,23,23,0,18,17,1,-0.170731707317073,0.170731707317073,346,335
51,12:24:53,0.25,29,29,0,19,18,1,-0.25,0.25,296,315
52,12:24:54,0.285714285714286,35,35,0,21,20,1,-0.285714285714286,0.285714285714286,296,315
53,12:24:55,0.310344827586207,56,55,1,31,29,2,-0.310344827586207,0.310344827586207,271,315
54,12:24:56,0.38,68,67,1,32,30,2,-0.38,0.38,271,295
55,12:24:57,0.38,68,67,1,32,30,2,-0.38,0.38,271,295
56,12:24:58,0.38,68,67,1,32,30,2,-0.38,0.38,271,295
57,12:24:59,0.38,68,67,1,32,30,2,-0.38,0.38,271,273
58,12:25:00,0.38,68,67,1,32,30,2,-0.38,0.38,271,273
59,12:25:03,0.377777777777778,61,60,1,29,27,2,-0.377777777777778,0.377777777777778,246,251
60,12:25:04,0.395348837209302,59,58,1,27,25,2,-0.395348837209302,0.395348837209302,246,251
61,12:25:05,0.404761904761905,58,57,1,26,24,2,-0.404761904761905,0.404761904761905,246,241
62,12:25:06,0.525423728813559,45,44,1,14,13,1,-0.525423728813559,0.525423728813559,246,241
63,12:25:07,0.5,39,38,1,13,12,1,-0.5,0.5,236,241
64,12:25:08,0.5,39,38,1,13,12,1,-0.5,0.5,236,215
65,12:25:09,0.523809523809524,32,31,1,10,9,1,-0.523809523809524,0.523809523809524,236,215
66,12:25:10,0.846153846153846,12,12,0,1,1,0,-0.846153846153846,0.846153846153846,206,215
67,12:25:11,0,0,0,0,0,0,0,0,0,206,191
68,12:25:12,0,0,0,0,0,0,0,0,0,206,191
69,12:25:13,0,0,0,0,0,0,0,0,0,174,191
70,12:25:14,0,0,0,0,0,0,0,0,0,174,71
71,12:25:15,0,0,0,0,0,0,0,0,0,174,71
72,12:25:16,0,0,0,0,0,0,0,0,0,174,71
73,12:25:17,1,2,2,0,0,0,0,-1,1,174,71
74,12:25:18,0.6,3,3,0,2,1,1,-0.6,0.6,174,71
75,12:25:19,0.6,3,3,0,12,3,9,-0.6,0.6,29,71
76,12:25:20,0.461538461538462,12,10,2,14,5,9,-0.461538461538462,0.461538461538462,29,71
77,12:25:21,0.351351351351351,18,16,2,19,10,9,-0.351351351351351,0.351351351351351,29,71
78,12:25:22,0.304347826086957,23,21,2,23,14,9,-0.304347826086957,0.304347826086957,29,71
79,12:25:23,0.222222222222222,25,23,2,29,19,10,-0.222222222222222,0.222222222222222,29,59
80,12:25:24,0.264705882352941,35,33,2,33,23,10,-0.264705882352941,0.264705882352941,29,59
81,12:25:30,0,0,0,0,0,0,0,0,0,395,377
82,12:25:31,0.111111111111111,5,5,0,4,4,0,-0.111111111111111,0.111111111111111,395,377
83,12:25:32,0.0588235294117647,9,9,0,8,8,0,-0.0588235294117647,0.0588235294117647,395,362
84,12:25:33,0.0588235294117647,9,9,0,8,8,0,-0.0588235294117647,0.0588235294117647,395,362
85,12:25:34,0.0588235294117647,9,9,0,8,8,0,-0.0588235294117647,0.0588235294117647,383,362
86,12:25:35,0.0588235294117647,9,9,0,8,8,0,-0.0588235294117647,0.0588235294117647,383,324
87,12:25:36,0.0588235294117647,9,9,0,8,8,0,-0.0588235294117647,0.0588235294117647,383,324
88,12:25:37,0.0588235294117647,9,9,0,8,8,0,-0.0588235294117647,0.0588235294117647,333,324
89,12:25:38,0.0588235294117647,9,9,0,8,8,0,-0.0588235294117647,0.0588235294117647,333,312
90,12:25:41,0.0588235294117647,9,9,0,8,8,0,-0.0588235294117647,0.0588235294117647,333,304
91,12:25:42,0.0588235294117647,9,9,0,8,8,0,-0.0588235294117647,0.0588235294117647,333,304
92,12:25:43,0.0588235294117647,9,9,0,8,8,0,-0.0588235294117647,0.0588235294117647,333,304
93,12:25:44,0.0588235294117647,9,9,0,8,8,0,-0.0588235294117647,0.0588235294117647,333,254
94,12:25:45,0.0588235294117647,9,9,0,8,8,0,-0.0588235294117647,0.0588235294117647,333,254
95,12:25:46,0,4,4,0,4,4,0,0,0,323,254
96,12:25:47,1,0,0,0,1,0,1,-1,1,323,224
97,12:25:48,0.6,0,0,0,15,3,12,-0.6,0.6,323,224
98,12:25:49,0.6,4,4,0,36,8,28,-0.6,0.6,303,224
99,12:25:50,0.483870967741935,4,4,0,58,16,42,-0.483870967741935,0.483870967741935,303,224
100,12:26:02,0.425287356321839,7,7,0,80,25,55,-0.425287356321839,0.425287356321839,261,176
101,12:26:02,0.425287356321839,7,7,0,80,25,55,-0.425287356321839,0.425287356321839,261,176
102,12:26:03,0.349397590361446,9,9,0,74,27,47,-0.349397590361446,0.349397590361446,261,176
103,12:26:04,0.275862068965517,5,5,0,53,21,32,-0.275862068965517,0.275862068965517,231,176
104,12:26:05,0.189189189189189,5,5,0,32,15,17,-0.189189189189189,0.189189189189189,231,176
105,12:26:06,0.1875,5,5,0,27,13,14,-0.1875,0.1875,231,176
106,12:26:07,0.1875,5,5,0,27,13,14,-0.1875,0.1875,216,164
107,12:26:10,0.1875,5,5,0,27,13,14,-0.1875,0.1875,206,164
108,12:26:11,0.1875,5,5,0,27,13,14,-0.1875,0.1875,206,164
109,12:26:12,0.1875,5,5,0,27,13,14,-0.1875,0.1875,206,164
110,12:26:13,0.0769230769230769,2,2,0,11,6,5,-0.0769230769230769,0.0769230769230769,196,144
111,12:26:14,0.0769230769230769,2,2,0,11,6,5,-0.0769230769230769,0.0769230769230769,196,144
112,12:26:15,0.0769230769230769,2,2,0,11,6,5,-0.0769230769230769,0.0769230769230769,196,144
113,12:26:16,0.0769230769230769,2,2,0,11,6,5,-0.0769230769230769,0.0769230769230769,184,134
114,12:26:17,0.166666666666667,2,2,0,10,5,5,-0.166666666666667,0.166666666666667,184,134
115,12:26:18,0.466666666666667,2,1,1,13,3,10,-0.466666666666667,0.466666666666667,184,134
116,12:26:19,0.428571428571429,6,4,2,22,6,16,-0.428571428571429,0.428571428571429,174,134
117,12:26:22,0.235294117647059,10,5,5,24,8,16,-0.235294117647059,0.235294117647059,174,104
118,12:26:35,0.148936170212766,18,9,9,29,11,18,-0.148936170212766,0.148936170212766,0,99
119,12:26:35,0.0434782608695652,14,8,6,9,5,4,-0.0434782608695652,0.0434782608695652,0,99
120,12:26:39,0.185185185185185,14,9,5,13,6,7,-0.185185185185185,0.185185185185185,0,99
121,12:26:40,0.304347826086957,27,20,7,19,9,10,-0.304347826086957,0.304347826086957,0,99
122,12:26:41,0.283018867924528,31,23,8,22,11,11,-0.283018867924528,0.283018867924528,0,99
123,12:26:42,0.283018867924528,31,23,8,22,11,11,-0.283018867924528,0.283018867924528,0,99
124,12:26:43,0.283018867924528,31,23,8,22,11,11,-0.283018867924528,0.283018867924528,0,99
125,12:26:44,0.283018867924528,31,23,8,22,11,11,-0.283018867924528,0.283018867924528,0,99
126,12:26:48,0.283018867924528,31,23,8,22,11,11,-0.283018867924528,0.283018867924528,0,99
127,12:26:48,0,0,0,0,0,0,0,0,0,0,99
128,12:26:49,0,0,0,0,0,0,0,0,0,0,99
129,12:26:50,0,0,0,0,0,0,0,0,0,0,99
130,12:26:51,0,0,0,0,0,0,0,0,0,0,99
131,12:26:52,0,0,0,0,0,0,0,0,0,0,99
132,12:26:53,0,0,0,0,0,0,0,0,0,0,99
133,12:26:54,0,0,0,0,0,0,0,0,0,0,99
134,12:26:55,0,0,0,0,0,0,0,0,0,0,99
135,12:26:56,0,0,0,0,0,0,0,0,0,0,99
136,12:26:57,0,0,0,0,0,0,0,0,0,0,99
137,12:26:59,0,0,0,0,0,0,0,0,0,0,99
138,12:26:59,0,0,0,0,0,0,0,0,0,0,99
139,12:27:00,0,0,0,0,0,0,0,0,0,0,99
140,12:27:01,0,0,0,0,0,0,0,0,0,0,99
141,12:27:02,0,0,0,0,0,0,0,0,0,0,99
142,12:27:03,0,0,0,0,0,0,0,0,0,0,99
143,12:27:04,0,0,0,0,0,0,0,0,0,0,99
144,12:27:05,0,0,0,0,0,0,0,0,0,0,99
145,12:27:06,0,0,0,0,0,0,0,0,0,0,99
146,12:27:07,0,0,0,0,0,0,0,0,0,0,99
147,12:27:08,0,0,0,0,0,0,0,0,0,0,99
148,12:27:10,0,0,0,0,0,0,0,0,0,0,99
149,12:27:10,0,0,0,0,0,0,0,0,0,0,99
150,12:27:11,0,0,0,0,0,0,0,0,0,0,99
151,12:27:13,0,0,0,0,0,0,0,0,0,0,99
152,12:27:14,0,0,0,0,0,0,0,0,0,0,99
153,12:27:15,0,0,0,0,0,0,0,0,0,0,99
154,12:27:16,0,0,0,0,0,0,0,0,0,0,99
155,12:27:17,0,0,0,0,0,0,0,0,0,0,99
156,12:27:18,0,0,0,0,0,0,0,0,0,0,99
157,12:27:19,0,0,0,0,0,0,0,0,0,0,99
158,12:27:21,0,0,0,0,0,0,0,0,0,0,99
159,12:27:21,0,0,0,0,0,0,0,0,0,0,99
160,12:27:22,0,0,0,0,0,0,0,0,0,0,99
161,12:27:23,0,0,0,0,0,0,0,0,0,0,99
162,12:27:24,0,0,0,0,0,0,0,0,0,0,99
163,12:27:25,0,0,0,0,0,0,0,0,0,0,99
164,12:27:26,0,0,0,0,0,0,0,0,0,0,99
165,12:27:27,0,0,0,0,0,0,0,0,0,0,99
166,12:27:28,0,0,0,0,0,0,0,0,0,0,99
167,12:27:29,0,0,0,0,0,0,0,0,0,0,99
168,12:27:30,0,0,0,0,0,0,0,0,0,0,99
169,12:27:32,0,0,0,0,0,0,0,0,0,0,99
170,12:27:32,0,0,0,0,0,0,0,0,0,0,99
171,12:27:33,0,0,0,0,0,0,0,0,0,0,99
172,12:27:34,0,0,0,0,0,0,0,0,0,0,99
173,12:27:35,0,0,0,0,0,0,0,0,0,0,99
174,12:27:36,0,0,0,0,0,0,0,0,0,0,99
175,12:27:37,0,0,0,0,0,0,0,0,0,0,99
176,12:27:38,0,0,0,0,0,0,0,0,0,0,99
177,12:27:39,0,0,0,0,0,0,0,0,0,0,99
178,12:27:40,0,0,0,0,0,0,0,0,0,0,99
179,12:27:41,0,0,0,0,0,0,0,0,0,0,99
180,12:27:43,0,0,0,0,0,0,0,0,0,0,99
181,12:27:43,0,0,0,0,0,0,0,0,0,0,99
182,12:27:44,0,0,0,0,0,0,0,0,0,0,99
183,12:27:45,0,0,0,0,0,0,0,0,0,0,99
184,12:27:46,0,0,0,0,0,0,0,0,0,0,99
185,12:27:47,0,0,0,0,0,0,0,0,0,0,99
186,12:27:48,0,0,0,0,0,0,0,0,0,0,99
187,12:27:49,0,0,0,0,0,0,0,0,0,0,99
188,12:27:50,0,0,0,0,0,0,0,0,0,0,99
189,12:27:51,0,0,0,0,0,0,0,0,0,0,99
190,12:27:52,0,0,0,0,0,0,0,0,0,0,99
191,12:27:54,0,0,0,0,0,0,0,0,0,0,99
192,12:27:54,0,0,0,0,0,0,0,0,0,0,99
193,12:27:55,0,0,0,0,0,0,0,0,0,0,99
194,12:27:56,0,0,0,0,0,0,0,0,0,0,99
195,12:27:57,0,0,0,0,0,0,0,0,0,0,99
196,12:27:58,0,0,0,0,0,0,0,0,0,0,99
197,12:27:59,0,0,0,0,0,0,0,0,0,0,99
198,12:28:00,0,0,0,0,0,0,0,0,0,0,99
199,12:28:01,0,0,0,0,0,0,0,0,0,0,99
200,12:28:02,0,0,0,0,0,0,0,0,0,0,99
201,12:28:03,0,0,0,0,0,0,0,0,0,0,99
202,12:28:05,0,0,0,0,0,0,0,0,0,0,99
203,12:28:06,0,0,0,0,0,0,0,0,0,0,99
204,12:28:07,0,0,0,0,0,0,0,0,0,0,99
205,12:28:08,0,0,0,0,0,0,0,0,0,0,99
206,12:28:09,0,0,0,0,0,0,0,0,0,0,99
207,12:28:10,0,0,0,0,0,0,0,0,0,0,99
208,12:28:11,0,0,0,0,0,0,0,0,0,0,99
209,12:28:12,0,0,0,0,0,0,0,0,0,0,99
210,12:28:13,0,0,0,0,0,0,0,0,0,0,99
211,12:28:14,0,0,0,0,0,0,0,0,0,0,99
212,12:28:15,0,0,0,0,0,0,0,0,0,0,99
213,12:28:16,0,0,0,0,0,0,0,0,0,0,99
214,12:28:17,0,0,0,0,0,0,0,0,0,0,99
215,12:28:18,0,0,0,0,0,0,0,0,0,0,99
216,12:28:19,0,0,0,0,0,0,0,0,0,0,99
217,12:28:20,0,0,0,0,0,0,0,0,0,0,99
218,12:28:21,0,0,0,0,0,0,0,0,0,0,99
219,12:28:22,0,0,0,0,0,0,0,0,0,0,99
220,12:28:23,0,0,0,0,0,0,0,0,0,0,99
221,12:28:24,0,0,0,0,0,0,0,0,0,0,99
222,12:28:25,0,0,0,0,0,0,0,0,0,0,99
223,12:28:26,0,0,0,0,0,0,0,0,0,0,99
224,12:28:27,0,0,0,0,0,0,0,0,0,0,99
225,12:28:28,0,0,0,0,0,0,0,0,0,0,99
226,12:28:29,0,0,0,0,0,0,0,0,0,0,99
227,12:28:30,0,0,0,0,0,0,0,0,0,0,99
228,12:28:31,0,0,0,0,0,0,0,0,0,0,99
229,12:28:32,0,0,0,0,0,0,0,0,0,0,99
230,12:28:33,0,0,0,0,0,0,0,0,0,0,99
231,12:28:34,0,0,0,0,0,0,0,0,0,0,99
232,12:28:35,0,0,0,0,0,0,0,0,0,0,99
233,12:28:36,0,0,0,0,0,0,0,0,0,0,99
234,12:28:37,0,0,0,0,0,0,0,0,0,0,99
235,12:28:38,0,0,0,0,0,0,0,0,0,0,99
236,12:28:39,0,0,0,0,0,0,0,0,0,0,99
237,12:28:40,0,0,0,0,0,0,0,0,0,0,99
238,12:28:41,0,0,0,0,0,0,0,0,0,0,99
239,12:28:42,0,0,0,0,0,0,0,0,0,0,99
240,12:28:43,0,0,0,0,0,0,0,0,0,0,99
241,12:28:44,0,0,0,0,0,0,0,0,0,0,99
242,12:28:45,0,0,0,0,0,0,0,0,0,0,99
243,12:28:46,0,0,0,0,0,0,0,0,0,0,99
244,12:28:47,0,0,0,0,0,0,0,0,0,0,99
245,12:28:48,0,0,0,0,0,0,0,0,0,0,99
246,12:28:49,0,0,0,0,0,0,0,0,0,0,99
247,12:28:50,0,0,0,0,0,0,0,0,0,0,99
248,12:28:51,0,0,0,0,0,0,0,0,0,0,99
249,12:28:52,0,0,0,0,0,0,0,0,0,0,99
250,12:28:53,0,0,0,0,0,0,0,0,0,0,99
251,12:28:54,0,0,0,0,0,0,0,0,0,0,99
252,12:28:55,0,0,0,0,0,0,0,0,0,0,99
253,12:28:56,-1,0,0,0,1,1,0,1,-1,0,99
254,12:28:57,-1,0,0,0,1,1,0,1,-1,0,99
255,12:28:58,-1,1,0,1,1,1,0,1,-1,0,99
256,12:28:59,-1,1,0,1,1,1,0,1,-1,0,99
257,12:29:00,-1,1,0,1,2,2,0,1,-1,0,99
258,12:29:01,-1,1,0,1,2,2,0,1,-1,0,99
259,12:29:02,-1,2,0,2,2,2,0,1,-1,0,99
260,12:29:03,-1,2,0,2,2,2,0,1,-1,0,99
261,12:29:04,-1,2,0,2,3,3,0,1,-1,0,99
262,12:29:05,-1,2,0,2,3,3,0,1,-1,0,99
263,12:29:06,-1,3,0,3,3,3,0,1,-1,0,99
264,12:29:07,-1,3,0,3,3,3,0,1,-1,0,99
265,12:29:08,-1,3,0,3,4,4,0,1,-1,0,99
266,12:29:09,-1,3,0,3,4,4,0,1,-1,0,99
267,12:29:10,-1,4,0,4,4,4,0,1,-1,0,99
268,12:29:11,-1,4,0,4,3,3,0,1,-1,0,99
269,12:29:12,-1,4,0,4,4,4,0,1,-1,0,99
270,12:29:13,-1,3,0,3,4,4,0,1,-1,0,99
271,12:29:14,-1,4,0,4,4,4,0,1,-1,0,99
272,12:29:15,-1,4,0,4,3,3,0,1,-1,0,99
273,12:29:16,-1,4,0,4,4,4,0,1,-1,0,99
274,12:29:17,-1,3,0,3,4,4,0,1,-1,0,99
275,12:29:18,-1,4,0,4,4,4,0,1,-1,0,99
276,12:29:19,-1,4,0,4,3,3,0,1,-1,0,99
277,12:29:20,-1,4,0,4,4,4,0,1,-1,0,99
278,12:29:21,-1,3,0,3,4,4,0,1,-1,0,99
279,12:29:22,-1,4,0,4,4,4,0,1,-1,0,99
280,12:29:23,-1,4,0,4,3,3,0,1,-1,0,99
281,12:29:24,-1,4,0,4,4,4,0,1,-1,0,99
282,12:29:25,-1,3,0,3,4,4,0,1,-1,0,99
283,12:29:26,-1,4,0,4,4,4,0,1,-1,0,99
284,12:29:27,-1,4,0,4,3,3,0,1,-1,0,99
285,12:29:28,-1,4,0,4,4,4,0,1,-1,0,99
286,12:29:29,-1,3,0,3,4,4,0,1,-1,0,99
287,12:29:30,-1,4,0,4,4,4,0,1,-1,0,99
288,12:29:31,-1,4,0,4,3,3,0,1,-1,0,99
289,12:29:32,-1,4,0,4,4,4,0,1,-1,0,99
290,12:29:33,-1,3,0,3,4,4,0,1,-1,0,99
291,12:29:34,-1,4,0,4,4,4,0,1,-1,0,99
292,12:29:35,-1,4,0,4,3,3,0,1,-1,0,99
293,12:29:36,-1,4,0,4,4,4,0,1,-1,0,99
294,12:29:37,-1,3,0,3,4,4,0,1,-1,0,99
295,12:29:38,-1,4,0,4,4,4,0,1,-1,0,99
296,12:29:39,-1,4,0,4,3,3,0,1,-1,0,99
297,12:29:40,-1,4,0,4,4,4,0,1,-1,0,99
298,12:29:41,-1,3,0,3,4,4,0,1,-1,0,99
299,12:29:42,-1,4,0,4,4,4,0,1,-1,0,99
300,12:29:43,-1,4,0,4,3,3,0,1,-1,0,99
301,12:29:44,-1,4,0,4,4,4,0,1,-1,0,99
302,12:29:45,-1,3,0,3,4,4,0,1,-1,0,99
303,12:29:46,-1,4,0,4,4,4,0,1,-1,0,99
304,12:29:47,-1,4,0,4,3,3,0,1,-1,0,99
305,12:29:48,-1,4,0,4,4,4,0,1,-1,0,99
306,12:29:49,-1,3,0,3,4,4,0,1,-1,0,99
307,12:29:50,-1,4,0,4,4,4,0,1,-1,0,99
308,12:29:51,-1,4,0,4,3,3,0,1,-1,0,99
309,12:29:52,-1,4,0,4,4,4,0,1,-1,0,99
310,12:29:53,-1,3,0,3,4,4,0,1,-1,0,99
311,12:29:54,-1,4,0,4,4,4,0,1,-1,0,99
312,12:29:56,-1,4,0,4,3,3,0,1,-1,0,99
313,12:29:56,-1,4,0,4,4,4,0,1,-1,0,99
314,12:29:57,-1,3,0,3,4,4,0,1,-1,0,99
315,12:29:58,-1,4,0,4,4,4,0,1,-1,0,99
316,12:29:59,-1,4,0,4,3,3,0,1,-1,0,99
317,12:30:00,-1,4,0,4,4,4,0,1,-1,0,99
318,12:30:01,-1,3,0,3,4,4,0,1,-1,0,99
319,12:30:02,-1,4,0,4,4,4,0,1,-1,0,99
320,12:30:03,-1,4,0,4,3,3,0,1,-1,0,99
321,12:30:04,-1,4,0,4,4,4,0,1,-1,0,0
322,12:30:05,-1,3,0,3,4,4,0,1,-1,0,0
323,12:30:07,-1,4,0,4,4,4,0,1,-1,0,400
324,12:30:07,-1,4,0,4,3,3,0,1,-1,0,400
325,12:30:08,-1,4,0,4,4,4,0,1,-1,0,400
326,12:30:09,0,0,0,0,0,0,0,0,0,390,390
327,12:30:10,1,1,1,0,0,0,0,-1,1,390,390
328,12:30:11,1,2,2,0,0,0,0,-1,1,390,390
329,12:30:12,0.6,5,4,1,0,0,0,-0.6,0.6,390,380
330,12:30:13,0.636363636363636,10,9,1,1,1,0,-0.636363636363636,0.636363636363636,390,380
331,12:30:14,0.75,15,14,1,1,1,0,-0.75,0.75,390,380
332,12:30:15,0.739130434782609,22,20,2,1,1,0,-0.739130434782609,0.739130434782609,390,380
333,12:30:16,0.793103448275862,28,26,2,1,1,0,-0.793103448275862,0.793103448275862,390,380
334,12:30:20,0.771428571428571,31,29,2,4,2,2,-0.771428571428571,0.771428571428571,390,370
335,12:30:20,0.736842105263158,33,30,3,5,2,3,-0.736842105263158,0.736842105263158,390,370
336,12:30:21,0.727272727272727,35,32,3,9,3,6,-0.727272727272727,0.727272727272727,390,370
337,12:30:22,0.773584905660377,41,38,3,12,3,9,-0.773584905660377,0.773584905660377,390,370
338,12:30:23,0.774193548387097,48,44,4,14,3,11,-0.774193548387097,0.774193548387097,390,370
339,12:30:24,0.818181818181818,59,55,4,18,3,15,-0.818181818181818,0.818181818181818,390,370
340,12:30:25,0.829787234042553,70,66,4,24,4,20,-0.829787234042553,0.829787234042553,390,370
341,12:30:26,0.866666666666667,77,74,3,28,4,24,-0.866666666666667,0.866666666666667,390,370
342,12:30:27,0.846153846153846,76,72,4,28,4,24,-0.846153846153846,0.846153846153846,385,360
343,12:30:28,0.84,72,68,4,28,4,24,-0.84,0.84,385,360
344,12:30:29,0.829787234042553,66,62,4,28,4,24,-0.829787234042553,0.829787234042553,385,360
345,12:30:32,0.839080459770115,59,56,3,28,4,24,-0.839080459770115,0.839080459770115,385,311
346,12:30:32,0.815789473684211,51,47,4,25,3,22,-0.815789473684211,0.815789473684211,385,311
347,12:30:33,0.792207792207792,51,47,4,26,4,22,-0.792207792207792,0.792207792207792,360,289
348,12:30:34,0.792207792207792,51,47,4,26,4,22,-0.792207792207792,0.792207792207792,360,289
349,12:30:35,0.789473684210526,50,46,4,26,4,22,-0.789473684210526,0.789473684210526,360,289
350,12:30:36,0.774647887323944,49,45,4,22,4,18,-0.774647887323944,0.774647887323944,360,277
351,12:30:37,0.741935483870968,42,38,4,20,4,16,-0.741935483870968,0.741935483870968,360,277
352,12:30:38,0.725490196078431,34,31,3,17,4,13,-0.725490196078431,0.725490196078431,360,277
353,12:30:39,0.567567567567568,24,20,4,13,4,9,-0.567567567567568,0.567567567567568,340,259
354,12:30:40,0.416666666666667,18,14,4,6,3,3,-0.416666666666667,0.416666666666667,340,259
355,12:30:41,0.428571428571429,21,17,4,7,4,3,-0.428571428571429,0.428571428571429,340,259
356,12:30:45,0.674418604651163,36,33,3,7,4,3,-0.674418604651163,0.674418604651163,320,179
357,12:30:45,0.659574468085106,38,34,4,9,4,5,-0.659574468085106,0.659574468085106,320,179
358,12:30:49,0.692307692307692,42,37,5,10,3,7,-0.692307692307692,0.692307692307692,310,179
359,12:30:50,0.787878787878788,49,45,4,17,3,14,-0.787878787878788,0.787878787878788,310,179
360,12:30:51,0.802469135802469,57,52,5,24,3,21,-0.802469135802469,0.802469135802469,310,169
361,12:30:52,0.851063829787234,62,57,5,32,2,30,-0.851063829787234,0.851063829787234,310,169
362,12:30:53,0.851851851851852,69,64,5,39,3,36,-0.851851851851852,0.851851851851852,310,169
363,12:30:54,0.869158878504673,68,64,4,39,3,36,-0.869158878504673,0.869158878504673,275,154
364,12:30:58,0.844660194174757,64,59,5,39,3,36,-0.844660194174757,0.844660194174757,265,144
365,12:30:58,0.777777777777778,36,31,5,36,3,33,-0.777777777777778,0.777777777777778,265,144
366,12:30:59,0.753424657534247,37,31,6,36,3,33,-0.753424657534247,0.753424657534247,265,144
367,12:31:00,0.794117647058823,35,30,5,33,2,31,-0.794117647058823,0.794117647058823,245,124
368,12:31:01,0.753846153846154,33,28,5,32,3,29,-0.753846153846154,0.753846153846154,245,124
369,12:31:02,0.753846153846154,33,28,5,32,3,29,-0.753846153846154,0.753846153846154,245,124
370,12:31:03,0.727272727272727,34,28,6,32,3,29,-0.727272727272727,0.727272727272727,203,114
371,12:31:04,0.777777777777778,31,27,4,32,3,29,-0.777777777777778,0.777777777777778,203,114
372,12:31:05,0.673469387755102,23,19,4,26,4,22,-0.673469387755102,0.673469387755102,203,114
373,12:31:07,0.575757575757576,15,12,3,18,4,14,-0.575757575757576,0.575757575757576,183,114
374,12:31:08,0.2,11,7,4,9,4,5,-0.2,0.2,183,114
375,12:31:09,-1,4,0,4,3,3,0,1,-1,183,114
376,12:31:10,-1,4,0,4,4,4,0,1,-1,173,64
377,12:31:11,-0.555555555555556,5,2,3,4,4,0,0.555555555555556,-0.555555555555556,173,64
378,12:31:25,0,0,0,0,0,0,0,0,0,390,378
379,12:31:26,0.2,3,3,0,2,2,0,-0.2,0.2,390,378
380,12:31:27,0.764705882352941,12,12,0,5,2,3,-0.764705882352941,0.764705882352941,390,378
381,12:31:28,0.8125,22,22,0,10,3,7,-0.8125,0.8125,390,378
382,12:31:29,0.863636363636364,27,27,0,17,3,14,-0.863636363636364,0.863636363636364,390,378
383,12:31:30,0.854545454545454,31,30,1,24,3,21,-0.854545454545454,0.854545454545454,380,346
384,12:31:33,0.848484848484849,36,35,1,30,4,26,-0.848484848484849,0.848484848484849,380,346
385,12:31:34,0.85,47,45,2,33,4,29,-0.85,0.85,380,346
386,12:31:35,0.866666666666667,56,54,2,34,4,30,-0.866666666666667,0.866666666666667,380,300
387,12:31:38,0.852631578947368,60,58,2,35,5,30,-0.852631578947368,0.852631578947368,380,290
388,12:31:39,0.833333333333333,61,58,3,35,5,30,-0.833333333333333,0.833333333333333,375,290
389,12:31:40,0.814432989690722,61,58,3,36,6,30,-0.814432989690722,0.814432989690722,375,290
390,12:31:41,0.858585858585859,61,58,3,38,4,34,-0.858585858585859,0.858585858585859,375,265
391,12:31:42,0.833333333333333,56,52,4,40,4,36,-0.833333333333333,0.833333333333333,370,265
392,12:31:43,0.849462365591398,54,50,4,39,3,36,-0.849462365591398,0.849462365591398,370,265
393,12:31:46,0.802469135802469,50,46,4,31,4,27,-0.802469135802469,0.802469135802469,358,260
394,12:31:47,0.826086956521739,59,55,4,33,4,29,-0.826086956521739,0.826086956521739,358,252
395,12:31:48,0.829787234042553,62,58,4,32,4,28,-0.829787234042553,0.829787234042553,338,252
396,12:31:53,0.842696629213483,58,55,3,31,4,27,-0.842696629213483,0.842696629213483,293,232
397,12:31:54,0.811764705882353,53,48,5,32,3,29,-0.811764705882353,0.811764705882353,293,232
398,12:31:55,0.852631578947368,60,55,5,35,2,33,-0.852631578947368,0.852631578947368,293,232
399,12:31:58,0.8,56,51,5,24,3,21,-0.8,0.8,293,222
400,12:31:59,0.789473684210526,54,49,5,22,3,19,-0.789473684210526,0.789473684210526,293,209
401,12:32:00,0.766233766233766,54,49,5,23,4,19,-0.766233766233766,0.766233766233766,283,209
402,12:32:01,0.791044776119403,48,44,4,19,3,16,-0.791044776119403,0.791044776119403,283,209
403,12:32:02,0.719298245614035,40,35,5,17,3,14,-0.719298245614035,0.719298245614035,283,175
404,12:32:03,0.702127659574468,34,29,5,13,2,11,-0.702127659574468,0.702127659574468,271,175
405,12:32:05,0.58974358974359,27,22,5,12,3,9,-0.58974358974359,0.58974358974359,231,150
406,12:32:06,0.55,28,22,6,12,3,9,-0.55,0.55,231,150
407,12:32:07,0.55,28,22,6,12,3,9,-0.55,0.55,231,150
408,12:32:08,0.51219512195122,28,22,6,13,4,9,-0.51219512195122,0.51219512195122,231,140
409,12:32:09,0.533333333333333,20,17,3,10,4,6,-0.533333333333333,0.533333333333333,231,140
410,12:32:10,0.2,14,10,4,6,4,2,-0.2,0.2,231,140
411,12:32:11,0.111111111111111,12,8,4,6,4,2,-0.111111111111111,0.111111111111111,231,120
412,12:32:12,0.333333333333333,19,15,4,8,5,3,-0.333333333333333,0.333333333333333,216,120
413,12:32:13,0.461538461538462,19,16,3,7,4,3,-0.461538461538462,0.461538461538462,216,120
414,12:32:14,0.578947368421053,27,23,4,11,4,7,-0.578947368421053,0.578947368421053,216,120
415,12:32:15,0.708333333333333,36,32,4,12,3,9,-0.708333333333333,0.708333333333333,206,120
416,12:32:18,0.724137931034483,42,38,4,16,4,12,-0.724137931034483,0.724137931034483,194,105
417,12:32:18,0.728813559322034,43,39,4,16,4,12,-0.728813559322034,0.728813559322034,194,105
418,12:32:21,0.794117647058823,50,47,3,18,4,14,-0.794117647058823,0.794117647058823,184,85
419,12:32:22,0.807228915662651,59,55,4,24,4,20,-0.807228915662651,0.807228915662651,184,85
420,12:32:23,0.854166666666667,68,64,4,28,3,25,-0.854166666666667,0.854166666666667,184,85
421,12:32:24,0.847619047619048,75,71,4,30,4,26,-0.847619047619048,0.847619047619048,184,85
422,12:32:25,0,0,0,0,0,0,0,0,0,400,400
423,12:32:26,0,0,0,0,0,0,0,0,0,400,400
424,12:32:27,-1,1,0,1,0,0,0,1,-1,400,400
425,12:32:31,-1,1,0,1,0,0,0,1,-1,375,390
426,12:32:31,-1,2,0,2,1,1,0,1,-1,375,390
427,12:32:32,-1,2,0,2,1,1,0,1,-1,375,390
428,12:32:33,-1,2,0,2,2,2,0,1,-1,375,390
429,12:32:34,-1,2,0,2,2,2,0,1,-1,345,380
430,12:32:35,-1,3,0,3,2,2,0,1,-1,345,380
431,12:32:36,-1,3,0,3,2,2,0,1,-1,345,380
432,12:32:37,-1,3,0,3,3,3,0,1,-1,333,375
433,12:32:38,-1,3,0,3,3,3,0,1,-1,333,375
434,12:32:39,-1,4,0,4,3,3,0,1,-1,333,375
435,12:32:40,-1,4,0,4,3,3,0,1,-1,321,365
436,12:32:43,-0.333333333333333,5,1,4,7,4,3,0.333333333333333,-0.333333333333333,321,360
437,12:32:47,0.272727272727273,14,10,4,8,4,4,-0.272727272727273,0.272727272727273,296,340
438,12:32:48,0.533333333333333,22,18,4,8,3,5,-0.533333333333333,0.533333333333333,296,340
439,12:32:49,0.609756097560976,29,25,4,12,4,8,-0.609756097560976,0.609756097560976,251,318
440,12:32:50,0.702127659574468,32,29,3,15,4,11,-0.702127659574468,0.702127659574468,251,318
441,12:32:51,0.709090909090909,37,33,4,18,4,14,-0.709090909090909,0.709090909090909,241,318
442,12:32:52,0.777777777777778,41,37,4,22,3,19,-0.777777777777778,0.777777777777778,241,308
443,12:32:55,0.783783783783784,48,44,4,26,4,22,-0.783783783783784,0.783783783783784,241,290
444,12:32:56,0.815789473684211,51,47,4,25,3,22,-0.815789473684211,0.815789473684211,241,290
445,12:33:00,0.80952380952381,55,52,3,29,5,24,-0.80952380952381,0.80952380952381,231,280
446,12:33:01,0.810526315789474,64,61,3,31,6,25,-0.810526315789474,0.810526315789474,231,232
447,12:33:02,0.851063829787234,62,60,2,32,5,27,-0.851063829787234,0.851063829787234,231,232
448,12:33:03,0.811764705882353,54,51,3,31,5,26,-0.811764705882353,0.811764705882353,231,232
449,12:33:04,0.810810810810811,47,44,3,27,4,23,-0.810810810810811,0.810810810810811,231,187
450,12:33:05,0.764705882352941,43,40,3,25,5,20,-0.764705882352941,0.764705882352941,231,187
451,12:33:10,0.766666666666667,38,36,2,22,5,17,-0.766666666666667,0.766666666666667,211,170
452,12:33:10,0.619047619047619,29,25,4,13,4,9,-0.619047619047619,0.619047619047619,211,170
453,12:33:12,0.567567567567568,28,24,4,9,4,5,-0.567567567567568,0.567567567567568,181,170
454,12:33:13,0.608695652173913,34,30,4,12,5,7,-0.608695652173913,0.608695652173913,181,153
455,12:33:14,0.730769230769231,41,37,4,11,3,8,-0.730769230769231,0.730769230769231,181,153
456,12:33:15,0.692307692307692,41,36,5,11,3,8,-0.692307692307692,0.692307692307692,181,153
457,12:33:16,0.714285714285714,39,34,5,10,2,8,-0.714285714285714,0.714285714285714,181,131
458,12:33:17,0.692307692307692,41,36,5,11,3,8,-0.692307692307692,0.692307692307692,181,131
459,12:33:18,0.76271186440678,47,43,4,12,3,9,-0.76271186440678,0.76271186440678,61,131
460,12:33:19,0.761194029850746,52,47,5,15,3,12,-0.761194029850746,0.761194029850746,61,131
461,12:33:23,0.805555555555556,56,51,5,16,2,14,-0.805555555555556,0.805555555555556,51,126
462,12:33:23,0.76,57,52,5,18,4,14,-0.76,0.76,51,126
463,12:33:25,0.804878048780488,60,57,3,22,5,17,-0.804878048780488,0.804878048780488,41,121
464,12:33:26,0.824175824175824,68,65,3,23,5,18,-0.824175824175824,0.824175824175824,41,121
465,12:33:27,0.835051546391753,72,69,3,25,5,20,-0.835051546391753,0.835051546391753,0,91
466,12:33:28,0.851063829787234,69,66,3,25,4,21,-0.851063829787234,0.851063829787234,0,91
467,12:33:29,0.813953488372093,62,59,3,24,5,19,-0.813953488372093,0.813953488372093,0,91
468,12:33:30,0.818181818181818,54,52,2,23,5,18,-0.818181818181818,0.818181818181818,0,91
469,12:33:31,0.774647887323944,50,47,3,21,5,16,-0.774647887323944,0.774647887323944,0,91
470,12:33:32,0.777777777777778,44,41,3,19,4,15,-0.777777777777778,0.777777777777778,0,91
471,12:33:36,0.719298245614035,38,35,3,19,5,14,-0.719298245614035,0.719298245614035,0,91
472,12:33:36,0.627906976744186,29,26,3,14,5,9,-0.627906976744186,0.627906976744186,0,91
473,12:33:37,0.590909090909091,29,26,3,15,6,9,-0.590909090909091,0.590909090909091,0,91
474,12:33:38,0.590909090909091,29,26,3,15,6,9,-0.590909090909091,0.590909090909091,0,91
475,12:33:39,0.58974358974359,28,24,4,11,4,7,-0.58974358974359,0.58974358974359,0,91
476,12:33:40,0.588235294117647,25,21,4,9,3,6,-0.588235294117647,0.588235294117647,0,91
477,12:33:41,0.384615384615385,16,12,4,10,4,6,-0.384615384615385,0.384615384615385,0,91
478,12:33:42,0,7,4,3,7,4,3,0,0,0,91
479,12:33:43,-1,4,0,4,4,4,0,1,-1,0,91
480,12:33:44,-1,4,0,4,3,3,0,1,-1,0,91
481,12:33:45,-1,4,0,4,4,4,0,1,-1,0,91
482,12:33:47,-1,3,0,3,4,4,0,1,-1,0,91
483,12:33:47,-1,4,0,4,4,4,0,1,-1,0,91
484,12:33:48,-1,4,0,4,3,3,0,1,-1,0,91
485,12:33:49,-1,4,0,4,4,4,0,1,-1,0,91
486,12:33:50,-1,4,0,4,4,4,0,1,-1,0,91
487,12:33:51,-1,4,0,4,4,4,0,1,-1,0,91
488,12:33:52,-1,4,0,4,3,3,0,1,-1,0,91
489,12:33:53,-1,4,0,4,4,4,0,1,-1,0,91
490,12:33:54,-1,3,0,3,4,4,0,1,-1,0,91
491,12:33:55,-1,4,0,4,4,4,0,1,-1,0,91
492,12:33:56,-1,4,0,4,3,3,0,1,-1,0,91
493,12:33:58,-1,4,0,4,4,4,0,1,-1,0,91
494,12:33:59,-1,3,0,3,4,4,0,1,-1,0,91
495,12:34:00,-1,4,0,4,4,4,0,1,-1,0,91
496,12:34:01,-1,4,0,4,3,3,0,1,-1,0,91
497,12:34:02,-1,4,0,4,4,4,0,1,-1,0,91
498,12:34:03,-1,3,0,3,4,4,0,1,-1,0,91
499,12:34:04,-1,4,0,4,4,4,0,1,-1,0,91
500,12:34:05,-1,4,0,4,3,3,0,1,-1,0,91
501,12:34:06,-1,4,0,4,4,4,0,1,-1,0,91
502,12:34:07,-1,3,0,3,4,4,0,1,-1,0,91
503,12:34:08,-1,4,0,4,4,4,0,1,-1,0,91
504,12:34:09,-1,4,0,4,3,3,0,1,-1,0,91
505,12:34:10,-1,4,0,4,4,4,0,1,-1,0,91
506,12:34:11,-1,3,0,3,4,4,0,1,-1,0,91
507,12:34:12,-1,4,0,4,4,4,0,1,-1,0,91
508,12:34:13,-1,4,0,4,3,3,0,1,-1,0,91
509,12:34:14,-1,4,0,4,4,4,0,1,-1,0,91
510,12:34:15,-1,3,0,3,4,4,0,1,-1,0,91
511,12:34:16,-1,4,0,4,4,4,0,1,-1,0,91
512,12:34:17,-1,4,0,4,3,3,0,1,-1,0,91
513,12:34:18,-1,4,0,4,4,4,0,1,-1,0,91
514,12:34:19,-1,3,0,3,4,4,0,1,-1,0,91
515,12:34:20,-1,4,0,4,4,4,0,1,-1,0,91
516,12:34:21,-1,4,0,4,3,3,0,1,-1,0,91
517,12:34:22,-1,4,0,4,4,4,0,1,-1,0,91
518,12:34:23,-1,3,0,3,4,4,0,1,-1,0,91
519,12:34:24,-1,4,0,4,4,4,0,1,-1,0,91
520,12:34:25,-1,4,0,4,3,3,0,1,-1,0,91
521,12:34:26,-1,4,0,4,4,4,0,1,-1,0,91
522,12:34:27,-1,3,0,3,4,4,0,1,-1,0,91
523,12:34:28,-1,4,0,4,4,4,0,1,-1,0,91
524,12:34:29,-1,4,0,4,3,3,0,1,-1,0,91
525,12:34:30,-1,4,0,4,4,4,0,1,-1,0,91
526,12:34:31,-1,3,0,3,4,4,0,1,-1,0,91
527,12:34:32,-1,4,0,4,4,4,0,1,-1,0,91
528,12:34:33,-1,4,0,4,3,3,0,1,-1,0,91
